NO ./textures/bluestone.xpm
SO ./textures/wood.xpm
EA ./textures/redbrick.xpm
WE ./textures/greystone.xpm

C 0, 0, 255

F 127,127,127


        11111111111    11111111111111
        10000000001    10000000000001
        10110000011111110001000001111
        1001000000000000000000011
111111111011000001110000000000001
1N0000000001000001110111101111111
10000000000001011100000010001
10000000000001011101010010001
11000000110101011100000010001
10001000000000001100000010001
10000000000000001101010010001
1100000111010101111101111000111
11110111 1110101 101111010001
11111111 1111111 111111111111